111111111111
100000000001
100C001C0001
100001100001
10000P000E01
100001100001
100000000001
111111111111
