111111111111
100000000001
10PC001C0001
100111100001
10C00P000E01
111001100001
111000000001
111111111111
