111111111111
100000000001
10CC001C0C01
100111100C01
10C00P000E01
11100110CC01
111000100001
111111111111
