1111111111111
100100000C0C1
10000E1111001
1P0011E000001
1111111111111
