111111111111111111111111
1C000000000C00000C0001E1
111001010010001001010111
101001001010101001010101
1P0000000C00C000000000C1
111111111111111111111111
