111111111111111111111111
1CE00000000C00000C000001
111001010010001001010101
101001001010101001010101
1P0000000C00C000000000C1
111111111111111111111111
