11111111
10000001
10011C01
1P1E0001
11111111
